NO Cub3D-Destroyer/textures/north.xpm
SO Cub3D-Destroyer/textures/south.xpm
WE Cub3D-Destroyer/textures/west.xpm
EA Cub3D-Destroyer/textures/east.xpm

F 0,0,2147483
C 250,2,30,0

F 0,0,21





   1111111111111111111111111             111111111111
1000000000110000000000001               11111111011111
1011000001110000000000001                    111111
1001000000000000000000001
111111111011000001110000000000001
1000000000110000011101111111111111111111111111111111111111111111111111111
11110111111111011100000010001
11110111111111011101010010001
110000001101010111000000100011111111111111111111111111111111111111111111111111
10000000000000001100000010001
10000000000000001101010010001
111111111111111111111111111111
11000001110101011111011110N0111          
11110111 1110101 101111010001
11111111 1111111 111111111111                
1    1
1    1   1    11    111     
1        
1
1
1
1
1
1       
                                           


